1674585855
1566677689
1171960171
547810058
706207190
1206952660
55118078
1221404122
1932711571
1123693339
